W W W W W W W W W W W W W W W W W W W E W W W W W W W W W W W W W W W W W W W W
W O O O O O O O O W O O O O O O O O O O O O O O O O O O O O W O O O O O O O O W
W O O O O O O O O W O O O O O O O O O O O O O O O O O O O O W O O O O O O O O W
W O O O O O O O O W O O O O O O O O O O O O O O O O O O O O W O O O O O O O O W
W O O O O O O O O W O O O O O O O O O O O O O O O O O O O O W O O O O O O O O W
W O O O O O O O O W O O O O O O O O O O O O O O O O O O O O W O O O O O O O O W
W O O O O O O O O W O O O O O O O O O O O O O O O O O O O O W O O O O O O O O W
W O O O O O O O O W O O O O O O O O O O O O O O O O O O O O W O O O O O O O O W
W O O O O O O O O W O O O O O O O O W W W O O O O O O O O O W O O O O O O O O W
W O O O O O O O O W O O O O O O O O W W W O O O O O O O O O W O O O O O O O O W
W O O O O O O O O W O O O O O O O O W W W O O O O O O O O O W O O O O O O O O W
W O O O O O O O O W O O O O O O O O W W W O O O O O O O O O O O O O O O O O O W
W O O O O O O O O O O O O O O O O O W W W O O O O O O O O O W O O O O O O O O W
W O O O O O O O O W O O O O O O O O W W W O O O O O O O O O W O O O O O O O O W
W W W W W W W W W W O O O O O O O O W W W O O O O O O O O O W W W W W W W W W W
W O O O O O O O O W O O O O O O O O O O O O O O O O O O O O W O O O O O O O O W
W O O O O O O O O W O O O O O O O O O O O O O O O O O O O O W O O O O O O O O W
W O O O O O O O O W O O O O O O O O O O O O O O O O O O O O W O O O O O O O O W
W O O O O O O O O W O O O O O O O O O O O O O O O O O O O O W O O O O O O O O W
W O O O O O O O O W O O O O O O O O W W W O O O O O O O O O W O O O O O O O O W
W O O O O O O O O W O O O O O O O O W W W O O O O O O O O O W O O O O O O O O W
W O O O O O O O O W O O O O O O O O W W W O O O O O O O O O W O O O O O O O O W
W O O O O O O O O W O O O O O O O O W W W O O O O O O O O O W O O O O O O O O W
W O O O O O O O O W O O O O O O O O W W W O O O O O O O O O W O O O O O O O O W
W O O O O O O O O W O O O O O O O O W W W O O O O O O O O O W O O O O O O O O W
W O O O O O O O O W O O O O O O O O W W W O O O O O O O O O O O O O O O O O O W
W O O O O O O O O O O O O O O O O O W W W O O O O O O O O O W O O O O O O O O W
W O O O O O O O O W O O O O O O O O W W W O O O O O O O O O W O O O O O O O O W
W W W W W W W W W W O O O O O O O O W W W O O O O O O O O O W W W W W W W W W W
W O O O O O O O O W O O O O O O O O W W W O O O O O O O O O W O O O O O O O O W
W O O O O O O O O W O O O O O O O O W W W O O O O O O O O O W O O O O O O O O W
W O O O O O O O O W O O O O O O O O W W W O O O O O O O O O W O O O O O O O O W
W O O O O O O O O W O O O O O O O O W W W O O O O O O O O O W O O O O O O O O W
W O O O O O O O O W O O O O O O O O W W W O O O O O O O O O W O O O O O O O O W
W O O O O O O O O W O O O O O O O O W W W O O O O O O O O O W O O O O O O O O W
W O O O O O O O O W O O O O O O O O W W W O O O O O O O O O W O O O O O O O O W
W O O O O O O O O W O O O O O O O O W W W O O O O O O O O O W O O O O O O O O W
W O O O O O O O O W O O O O O O O O W W W O O O O O O O O O W O O O O O O O O W
W O O O O O O O O W O O O O O O O O W W W O O O O O O O O O W O O O O O O O O W
W O O O O O O O O O O O O O O O O O W W W O O O O O O O O O W O O O O O O O O W
W O O O O O O O O W O O O O O O O O O O O O O O O O O O O O O O O O O O O O O W
W O O O O O O O O W O O O O O O O O O O O O O O O O O O O O W O O O O O O O O W
W W W W W W W W W W O O O O O O O O O O O O O O O O O O O O W W W W W W W W W W
W O O O O O O O O O O O O O O O O O O O O O O O O O O O O O O O O O O O O O O W
W O O O O O O O O O O O O O O O O O O O O O O O O O O O O O O O O O O O O O O W
W O O O O O O O O O O O O O O O O O O O O O O O O O O O O O O O O O O O O O O W
W O O O O O O O O O O O O O O O O O O O O O O O O O O O O O O O O O O O O O O W
E O O O O O O O O O O O O O O O O O O O O O O O O O O O O O O O O O O O O O O W
W O O O O O O O O O O O O O O O O O O O O O O O O O O O O O O O O O O O O O O W
W O O O O O O O O O O O O O O O O O O O O O O O O O O O O O O O O O O O O O O W
W O O O O O O O O O O O O O O O O O O O O O O O O O O O O O O O O O O O O O O W
W O O O O O O O O O O O O O O O O O O O O O O O O O O O O O O O O O O O O O O W
W O O O O O O O O O O O O O O O O O O O O O O O O O O O O O O O O O O O O O O W
W O O O O O O O O O O O O O O O O O O O O O O O O O O O O O O O O O O O O O O W
W O O O O O O O O W W W W W W W W W W W W W W W W W W W W W O O O O O O O O O W
W O O O O O O O O O O O O O O O O O O O O O O O O O O O O O O O O O O O O O O W
W O O O O O O O O O O O O O O O O O O O O O O O O O O O O O O O O O O O O O O W
W O O O O O O O O O O O O O O O O O O O O O O O O O O O O O O O O O O O O O O W
W O O O O O O O O O O O O O O O O O O O O O O O O O O O O O O O O O O O O O O W
W O O O O O O O O O O O O O O O O O O O O O O O O O O O O O O O O O O O O O O W
W O O O O O O O O O O O O O O O O O O O O O O O O O O O O O O O O O O O O O O W
W O O O O O O O O O O O O O O O O O O O O O O O O O O O O O O O O O O O O O O W
W O O O O O O O O O O O O O O O O O O O O O O O O O O O O O O O O O O O O O O W
W O O O O O O O O O O O O O O O O O W W W O O O O O O O O O O O O O O O O O O W
W O O O O O O O O O O O O O O O O O W W W O O O O O O O O O O O O O O O O O O W
W O O O O O O O O O O O O O O O O O W W W O O O O O O O O O O O O O O O O O O W
W O O O O O O O O O O O O O O O O O O O O O O O O O O O O O O O O O O O O O O W
W O O O O O O O O O O O O O O O O O O O O O O O O O O O O O O O O O O O O O O W
W O O O O O O O O O O O O O O O O O O O O O O O O O O O O O O O O O O O O O O W
W O O O O O O O O O O O O O O O O O O O O O O O O O O O O O O O O O O O O O O W
W O O O O O O O O O O O O O O O O O O O O O O O O O O O O O O O O O O O O O O W
W O O O O O O O O O O O O O O O O O O O O O O O O O O O O O O O O O O O O O O W
W O O O O O O O O O O O O O O O O O O O O O O O O O O O O O O O O O O O O O O W
W O O O O O O O O O O O O O O O O O O O O O O O O O O O O O O O O O O O O O O W
W O O O O O O O O O O O O O O O O O O O O O O O O O O O O O O O O O O O O O O W
W O O O O O O O O O O O O O O O O O O O O O O O O O O O O O O O O O O O O O O W
W O O O O O O O O O O O O O O O O O O O O O O O O O O O O O O O O O O O O O O W
W O O O O O O O O O O O O O O O O O O O O O O O O O O O O O O O O O O O O O O W
W O O O O O O O O O O O O O O O O O O O O O O O O O O O O O O O O O O O O O O W
W W W W W W W W W W W W W W W W W W W E W W W W W W W W W W W W W W W W W W W W
